1111111111111111111111
1000000000000000000001
1000000000000000000111
1000000000000000001111
100000000000000C001001
1000000000000000001111
1000000000000000000001
1000000000000000000001
1000000000000000000001
10000000000000000000E1
10000P0000000000000111
1000000000000000001111
100000000000000C001001
1000000000000000001111
1111111111111111111111