11111111111111111111111111111111111111
1000000000000000000000000000000000C001
10000P00000000000000000000E00000000001
10000000000000000011111000000000000001
1000000000000000001C000000000000000001
10000C000000000000111110000000000C0001
11111111111111111111111111111111111111